i,h,b,a,0,0,0,0,0,A,B,H,H,H,H,H,H,H,H,I
i,h,b,a,0,0,0,0,0,A,B,H,H,H,H,H,H,H,H,I
i,h,b,a,0,0,0,0,0,A,B,H,H,H,H,H,H,H,H,I
i,h,b,a,0,0,0,0,0,A,B,H,H,H,H,H,H,H,H,I
i,h,b,D,0,0,0,0,0,E,B,H,H,H,H,H,H,H,H,I
i,h,b,d,0,0,0,0,0,e,B,H,H,H,H,H,H,H,H,I
i,h,b,a,0,0,0,0,0,A,B,H,H,H,H,H,H,H,H,I
i,h,b,a,0,0,0,0,0,A,B,H,H,H,H,H,H,H,H,I
i,h,b,a,0,0,0,0,0,A,B,H,H,H,H,H,H,H,H,I
i,h,b,a,0,0,0,0,0,A,B,H,H,H,H,H,H,H,H,I
i,h,b,a,0,0,0,0,0,A,B,H,H,H,H,H,H,H,H,I
i,h,b,D,0,0,0,0,0,E,B,H,H,H,H,H,H,H,H,I
i,h,b,d,0,0,0,0,0,e,B,H,H,H,H,H,H,H,H,I
i,h,b,a,0,0,0,0,0,A,B,H,H,H,H,H,H,H,H,I
i,h,b,a,0,0,0,0,0,A,B,H,H,H,H,H,H,H,H,I
i,h,b,a,0,0,0,0,0,A,B,H,H,H,H,H,H,H,H,I
i,h,b,a,0,0,0,0,0,A,B,H,H,H,H,H,H,H,H,I
i,h,b,a,0,0,0,0,0,A,B,H,H,H,H,H,H,H,H,I
i,h,b,D,0,0,0,0,0,E,B,H,H,H,H,H,H,H,H,I
i,h,b,d,0,0,0,0,0,e,B,H,H,H,H,H,H,H,H,I
i,h,b,a,0,0,0,0,0,A,B,H,H,H,H,H,H,H,H,I
i,h,b,a,0,0,0,0,0,A,B,H,H,H,H,H,H,H,H,I
i,h,b,a,0,0,0,0,0,A,B,H,H,H,H,H,H,H,H,I
i,h,b,a,0,0,0,0,0,A,B,H,H,H,H,H,H,H,H,I
i,h,b,a,0,0,0,0,0,A,B,H,H,H,H,H,H,H,H,I
i,h,b,D,0,0,0,0,0,E,B,H,H,H,H,H,H,H,H,I
i,h,b,d,0,0,0,0,0,e,B,H,H,H,H,H,H,H,H,I
i,h,b,a,0,0,0,0,0,A,B,H,H,H,H,H,H,H,H,I
i,h,b,a,0,0,0,0,0,A,B,H,H,H,H,H,H,H,H,I
i,h,b,a,0,0,0,0,0,A,B,H,H,H,H,H,H,H,H,I
i,h,b,a,0,0,0,0,0,A,B,H,H,H,H,H,H,H,H,I
i,h,b,a,0,0,0,0,0,A,B,H,H,H,H,H,H,H,H,I
i,h,b,D,0,0,0,0,0,E,B,H,H,H,H,H,H,H,H,I
i,h,b,d,0,0,0,0,0,e,B,H,H,H,H,H,H,H,H,I
i,h,b,a,0,0,0,0,0,A,B,H,H,H,H,H,H,H,H,I
i,h,b,a,0,0,0,0,0,A,B,H,H,H,H,H,H,H,H,I
i,h,b,a,0,0,0,0,0,A,B,H,H,H,H,H,H,H,H,I
i,h,b,a,0,0,0,0,0,A,B,H,H,H,H,H,H,H,H,I
i,h,b,a,0,0,0,0,0,A,B,H,H,H,H,H,H,H,H,I
i,h,b,D,0,0,0,0,0,E,B,H,H,H,H,H,H,H,H,I
i,h,b,d,0,0,0,0,0,e,B,H,H,H,H,H,H,H,H,I
i,h,b,a,0,0,0,0,0,A,B,H,H,H,H,H,H,H,H,I
i,h,b,a,0,0,0,0,0,A,B,H,H,H,H,H,H,H,H,I
i,h,b,a,0,0,0,0,0,A,B,H,H,H,H,H,H,H,H,I
i,h,b,a,0,0,0,0,0,A,B,H,H,H,H,H,H,H,H,I
i,h,b,a,0,0,0,0,0,A,B,H,H,H,H,H,H,H,H,I
i,h,b,D,0,0,0,0,0,E,B,H,H,H,H,H,H,H,H,I
i,h,b,d,0,0,0,0,0,e,B,H,H,H,H,H,H,H,H,I
i,h,b,a,0,0,0,0,0,A,B,H,H,H,H,H,H,H,H,I
i,h,b,a,0,0,0,0,0,A,B,H,H,H,H,H,H,H,H,I
i,h,b,a,0,0,0,0,0,A,B,H,H,H,H,H,H,H,H,I
i,h,b,a,0,0,0,0,0,A,B,H,H,H,H,H,H,H,H,I
i,h,b,a,0,0,0,0,0,A,B,H,H,H,H,H,H,H,H,I
i,h,b,D,0,0,0,0,0,E,B,H,H,H,H,H,H,H,H,I
i,h,b,d,0,0,0,0,0,e,B,H,H,H,H,H,H,H,H,I
i,h,b,a,0,0,0,0,0,A,B,H,H,H,H,H,H,H,H,I
i,h,b,a,0,0,0,0,0,A,B,H,H,H,H,H,H,H,H,I
i,h,b,a,0,0,0,0,0,A,B,H,H,H,H,H,H,H,H,I
i,h,b,a,0,0,0,0,0,A,B,H,H,H,H,H,H,H,H,I
i,h,b,a,0,0,0,0,0,A,B,H,H,H,H,H,H,H,H,I
i,h,b,D,0,0,0,0,0,E,B,H,H,H,H,H,H,H,H,I
i,h,b,d,0,0,0,0,0,e,B,H,H,H,H,H,H,H,H,I
i,h,b,a,0,0,0,0,0,A,B,H,H,H,H,H,H,H,H,I
i,h,b,a,0,0,0,0,0,A,B,H,H,H,H,H,H,H,H,I
i,h,b,a,0,0,0,0,0,A,B,H,H,H,H,H,H,H,H,I
i,h,b,a,0,0,0,0,0,A,B,H,H,H,H,H,H,H,H,I
i,h,b,a,0,0,0,0,0,A,B,H,H,H,H,H,H,H,H,I
i,h,b,D,0,0,0,0,0,E,B,H,H,H,H,H,H,H,H,I
i,h,b,d,0,0,0,0,0,e,B,H,H,H,H,H,H,H,H,I
i,h,b,a,0,0,0,0,0,A,B,H,I,g,g,g,g,g,g,g
i,h,b,a,0,0,0,0,0,A,B,I,g,0,0,0,0,0,0,g
i,h,b,a,0,0,0,0,0,F,g,g,0,0,0,0,0,0,0,g
i,h,b,a,0,0,0,0,0,0,0,0,0,0,0,0,0,0,0,g
i,h,b,a,0,0,0,0,0,0,0,0,0,0,0,0,0,0,0,m
i,h,b,D,0,0,0,0,0,0,0,0,0,0,0,0,0,0,0,k
i,h,b,d,0,0,0,0,0,0,0,0,0,0,0,0,0,0,0,K
g,g,g,f,c,c,c,c,c,c,c,c,c,c,c,c,c,c,c,g
g,g,g,g,C,C,C,C,C,C,C,C,C,C,C,C,C,C,C,g
g,g,g,g,j,j,j,j,j,j,j,j,j,j,j,j,j,j,j,g
g,g,g,g,J,J,J,J,J,J,J,J,J,J,J,J,J,J,J,g